%%%%%%%%%%%%%%%%%%%%
%....%...%......%...%
%.%%%.%%.%%.%%%%.%%.%
%..........%........%
%.%%%.%%.%%.%%.%%.%%.%
%........P%..%......%
%.%%%.%%.%%.%%.%%.%%%.
%......%........%....%
%.%%.%%.%%%%%%%%.%%.%
%........%...........%
%.%%.%%.%%.%%%%%.%%.%
%........%......%...%
%.%%%.%%%%%%%%%%.%%.%
%..................%
%%%%%%%%%%%%%%%%%%%%